80 10
0000000000000000000000000000000000000000000000000000000000000000000000000001100G
10000000000000000000000000000000000000000000000000000000000000000000000000000000
00000000000000000000000000000000000000000000000000000000000000000000000000011000
10000000000101000000000000000000000000000000000000000000000000000000000000000001
00000000010000001000000000000000000000000000000000000000000000000000000000011000
10000001000000000000000000000000000000000000000000000000000000000000000000000000
00000000000000000000000000000000000000000000000000000000000000000000000000011001
10000010000000000000100100100100100100011111111111111100000000000000000000000000
00001000000000000000000000000000000000000000000000000000000000000000000000101000
11000000000000000000000000000000000000000000000000000000001010101010101010111101