80 10
11111111111111111111111111111111111111011111111111111111111111111111111111111110
00000000000000000000001000000000000001000000000000000000000000000000001000000000
11111111101111111111111011111111111111111111111111000111111000000000001000000000
00010000000000000000000000000000000000010000000001100000001100000001001000000000
0001111111110111111111111111110111111111011111100010000000100000001110100G000001
00000000000000000000000000000100000000000000001111111111101000000111001001111111
00000000011111111111111110111111111110111111100000000000001100001111101000000000
01111111110000000000000000000000000000000000111111111111111000011111001000000000
00000000000000000000000000000000000000000000000000000000001000111111101000000000
11111111111111111111111111111111111111111111111101111111111111111111111111111111