80 10
00000000000000000001111111111111111111111111111111111111111111000000000000000000
0111110000000000000000000000000000000000000000000000000000000000000000000000000G
00000000000000000000000000000000000000000000000000000000000000000000000000000000
00000000111110000000000000000000000000000000000000000000000000000000000000001000
00000000000000000000000000000000000000000000000000000000000000000000000000011000
00000000000000000000000000000000000000000000000000000000000000000000000000111000
00000000001111100000000000000000000000000000000000000000000000000000000001111000
00000000000000000000000001100000000000000000000000000000000000000110000011111000
00000000000000000000000001100000000000000011111111110000000000000110000111111000
11111100000000000001111001111111111111000000000000000000111111111111111111111111