10 10
000001000G
0001010000
0001010000
1001010100
0001010000
0001010000
0101010010
0001010000
0001000000
1111111111